
11001001
11000011
11110111
00110111
00110111
00000000
11110000
11111111

11101111
11101110
11101110
11001110
10000011
00110011
11111000
11111011